XXXXXXXXXXXXXXXXXXXXXXXXXXXXXXXXXXIXXXXXXXXXXXXXXXXXXXXXXXXXX
X            X                                  X           X
X            X                                  X           X
XXXXXXXX     X                                  X           X
X                                               X           X
X                                                           X
X                                                           X
XXXXXXXXXXXXXXXXXXXXXXXXXXXXXXXXX                           X
X                 X                                         X
X                 X                                         X
X                 X        XXXXX                 XXXXXXXXXX X
X                 X        X                                X
X                 XXXXXXXXXXXXXX                            X
X                                                           X
X                                                           X
XXXXXXXXXXXXXXXXXXXXXXXX                                    X
X           X                                               X
X    X      XXXXXXXXXXXXX                                   X
X    X                                                      X
XXXXXXXXXXXXXXXXXXXXXXXXXXXXXXXXXX0XXXXXXXXXXXXXXXXXXXXXXXXXX
